###############
#      @      #
#    b   b    #
# #         ###
#*#    b   h#a#
#*#h   b    #*#
#a#    b   h#a#
#*#h   b    #*#
#a#    b   h#*#
###h   b    # #
#             #
#           b #
#######*#######
#1     x     *#
###############
